level_4.txt
1 1
2 1
3 1
2 2
4 2
2 4
4 5
-1
8 11
2 2 2 2 2 2 2 2 2 2 2
2 1 1 1 1 1 2 2 1 1 2
2 1 1 1 1 1 2 2 1 1 2
2 2 1 2 1 4 2 2 1 1 2
2 1 1 1 2 2 2 1 1 2 2
2 1 1 1 1 1 1 1 1 1 2
2 1 1 1 2 2 2 1 1 1 2
2 2 2 2 2 0 2 2 2 2 2