level_6.txt
8 11
2 2 2 2 2 2 2 2 2 2 2
2 4 3 3 1 1 2 2 1 1 2
2 1 5 1 5 1 2 2 1 1 2
2 2 1 2 1 3 2 2 1 1 2
2 1 5 1 2 2 2 1 1 2 2
2 1 1 1 5 1 1 1 1 2 2
2 1 1 1 2 2 2 1 1 1 2
2 2 2 2 2 0 2 2 2 2 2