level_2.txt
7 8
2 2 2 2 2 2 2 2
2 1 1 1 2 4 1 2
2 1 1 1 1 5 1 2
2 1 1 1 2 1 1 2
2 2 2 2 2 5 3 2
0 0 0 0 2 1 3 2
0 0 0 0 2 2 2 2