8 8
0 0 0 2 2 2 2 2
0 2 2 2 1 1 1 2
0 2 p 3 1 2 1 2
2 2 3 3 1 1 1 2
2 1 1 2 2 1 2 2
2 4 1 4 1 1 1 2
2 2 1 1 1 4 1 2
0 2 2 2 2 2 2 2