8 11
2 2 2 2 2 2 2 2 2 2 2
2 p 3 3 1 1 2 2 1 1 2
2 1 3 1 3 1 2 2 1 1 2
2 2 1 2 1 4 2 2 1 1 2
2 1 3 1 2 2 2 1 1 2 2
2 1 1 1 3 1 1 1 1 1 2
2 1 1 1 2 2 2 1 1 1 2
2 2 2 2 2 0 2 2 2 2 2