level_2.txt
5 1
5 2
5 4
-1
7 8
2 2 2 2 2 2 2 2
2 1 1 1 2 1 1 2
2 1 1 1 1 1 1 2
2 1 1 1 2 1 1 2
2 2 2 2 2 1 3 2
0 0 0 0 2 1 3 2
0 0 0 0 2 2 2 2