level_5.txt
8 8
0 0 0 2 2 2 2 2
0 2 2 2 1 1 1 2
0 2 4 5 1 2 1 2
2 2 5 5 1 1 1 2
2 1 1 2 2 1 2 2
2 3 1 3 1 1 1 2
2 2 1 1 1 3 1 2
0 2 2 2 2 2 2 2