none
7 5
2 5
6 5
8 5
9 3
-1
8 12
2 2 2 2 2 2 2 2 2 2 2 2
2 1 1 1 2 1 1 1 1 1 1 2
2 1 1 1 2 1 1 1 1 1 1 2
2 1 1 1 2 2 2 2 1 1 1 2
2 1 1 2 1 1 1 2 2 3 3 2
2 1 1 1 1 1 1 1 1 1 1 2
2 1 1 1 1 1 1 2 1 3 2 2
2 2 2 2 2 2 2 2 2 2 2 0 