8 12
2 2 2 2 2 2 2 2 2 2 2 2
2 1 1 1 2 1 1 1 1 1 1 2
2 1 1 1 2 1 1 1 1 1 1 2
2 1 1 1 2 2 2 2 1 3 1 2
2 1 1 2 1 1 1 2 2 4 4 2
2 1 3 1 1 1 3 p 3 1 1 2
2 1 1 1 1 1 1 2 1 4 2 2
2 2 2 2 2 2 2 2 2 2 2 0 