level_6.txt
1 1
2 3
3 2
4 2
-1
7 8
2 2 2 2 2 2 2 2
2 1 1 2 3 3 3 2
2 1 1 1 1 1 1 2
2 1 1 1 1 1 2 2
2 1 1 2 2 2 2 0
2 1 1 2 0 0 0 0
2 2 2 2 0 0 0 0