level_3.txt
5 9
2 2 2 2 2 2 2 2 2
2 4 1 1 2 1 1 1 2
2 1 1 5 5 5 1 1 2
2 3 3 1 1 1 1 1 2
2 2 2 2 2 2 2 2 2