level_5.txt
2 2
3 2
2 3
3 3
-1
8 8
0 0 0 2 2 2 2 2
0 2 2 2 1 1 1 2
0 2 1 1 1 2 1 2
2 2 1 1 1 1 1 2
2 1 1 2 2 1 2 2
2 3 1 3 1 1 1 2
2 2 1 1 1 3 1 2
0 2 2 2 2 2 2 2