none
8 12
2 2 2 2 2 2 2 2 2 2 2 2
2 1 1 1 2 1 1 1 1 1 1 2
2 1 1 1 2 1 1 1 1 1 1 2
2 1 1 1 2 2 2 2 1 5 1 2
2 1 1 2 1 1 1 2 2 3 3 2
2 1 5 1 1 1 5 4 5 1 1 2
2 1 1 1 1 1 1 2 1 3 2 2
2 2 2 2 2 2 2 2 2 2 2 0 