level_3.txt
1 1
3 2
4 2
5 2
-1
5 9
2 2 2 2 2 2 2 2 2
2 1 1 1 2 1 1 1 2
2 1 1 1 1 1 1 1 2
2 3 3 1 1 1 1 1 2
2 2 2 2 2 2 2 2 2